111111
1P00E1
10K001
100C11
1CC011
111111