1111111111111111111111111111111111
110000000000000C00000C00000E010001
1110010100100000101001000000010101
1010010010100010001001000001K00101
1P0000000C00C1000000000000000000C1
1111111111111111111111111111111111