11111111
1CCCC1P1
1CCCC101
1CCCC101
1CCCC101
1CCCC101
1CCCC101
1CCCC1E1
11111111