11111111
1C00P001
10000K01
1111C0E1
1CC10001
111111111