


11111111
1C00P001
10000K01
1011CE01
1CC10001
11111111