11111111
1C00P001
10000K01
spliti kontrol et
1011C001
1CC100E1
11111111