11111111
1C00P001
10P00K01
1011C001
1CC10E01
11111111