11111111
1000P001
1000CK01
11110001
10010E01
11111111