11111111
1C00P001
10000K01
1111C001
1CC10E01
11111111